1111111111111111111
1111111111111111111
1111111111111111111
0100000000000000010
0100000000000000010
0100000000000000010
0100000011100000010
0100010010100000010
0100000010100000010
0100000000000000010
0100000000000000010
0100000000000000010
0111111111111111110
1111111111111111111
1111111111111111111