BBBBBBBBBBBBBBBBBAAAB
BAAAAAAAAAAABAAAAAAAB
BBBBBAABBBBBBAABBBBAB
BAAAAAAAAAAABAAAAABAB
BAABBBBBBBBABAABBBBAB
BAAAAAAAAABABAAAAABAB
BBBBBBBBBBBABBBBBABAB
BAAAAAAAAAAAAAAAAABAB
BBBBBBBAABBBBBBBBBBAB
BAAAAAAAAAAAAAAAAABAB
BAABBBBBBBBBBBBBBABAB
BAAAAAAAAAAAAABAAABAB
BABAABBBBBBBBABBBBBAB
BABAAAAAAABAAAAAAABAB
BBBBBBBBBBBABBBBBABAB
BAAAAAAABAAABAAAAABAB
BAABBBBABAABBBBBBBBAB
BAAAAABABAAAAAAAAAAAB
BBBBBABABBBBBBBBBBBAB
BAAAAABAAAAAAAAAAAAAB
BBBBBBBBBBBBBBBBBBBBB